q	も
w	に
e	は
r	て
t	で
y	れ
u	っ
i	し
o	と
p	の
a	か
f	な
g	る
h	き
j	ん
;	い
z	こ
x	が
c	だ
v	た
b	ょ
n	く
m	う
,	、
.	。
kq	ご
kw	づ
ke	ぼ
kr	ほ
kt	へ
ka	あ
ks	け
kd	す
kf	お
kg	さ
kz	や
kx	ゆ
kc	ぜ
kv	ね
kb	よ
dy	ぉ
du	ぷ
di	ぶ
do	え
dp	ゃ
dh	ひ
dj	つ
dk	ち
dl	じ
d;	ま
dn	ぬ
dm	み
d,	ぺ
d.	ゅ
d/	ぴ
lq	べ
lw	ぃ
le	ぁ
lr	ど
lt	ぞ
la	ら
ls	せ
ld	わ
lf	ろ
lg	そ
lz	び
lx	ぇ
lc	げ
lv	ふ
lb	ざ
su	ぱ
si	ぽ
so	ば
sp	ず
sh	ぎ
sj	ー
sk	め
sl	り
s;	を
sn	ぐ
sm	む
s,	ヴ
s.	ぅ
s/	ぢ